症状=病症
哀求=乞求
爱财如命=一毛不拔
爱护=保护
安顿=安排
安全=平安
安适=安闲
安慰=抚慰
暗藏=隐藏
黯然失色=相形见绌
昂扬=高昂
奥妙=微妙
懊悔=悔恨
懊恼=烦恼
把戏=花招
罢职=撤职
白璧无瑕=完美无缺
百战百胜=战无不胜
败落=没落
败兴=扫兴
拜服=佩服
颁布=公布
版图=幅员
办法=方法
半途而废=前功尽弃
帮忙=帮助
榜样=典范
傍晚=黄昏
褒扬=表扬
宝贵=珍贵
保留=保存
抱头鼠窜=逃之夭夭
暴发=爆发
暴露无遗=原形毕露
暴跳如雷=大发雷霆
卑鄙=卑劣
卑下=卑贱
杯弓蛇影=草木皆兵
悲痛=悲哀
悲痛欲绝=欣喜若狂
背地=背后
背面=反面
背水一战=破釜沉舟
奔放=豪放
奔走=奔波
本末倒置=舍本逐末
本事=本领
本土=外乡
本源=根源
比较=比拟
比拟=比较
比如=比方
彼岸=此岸
必由之路=殊途同归
毕生=一生
闭会=休会
闭幕=落幕
壁垒森严=严阵以待
避免=防止
边远=遥远
编造=假造
便宜=廉价
变革=革新
遍及=普及
辨别=区分
辨认=识别
辩解=辩白
表里如一=心口如一
表面=外表
别树一帜=标新立异
别有用心=心怀叵测
宾至如归=门庭若市
摈弃=抛弃
兵士=战士
并行不悖=双管齐下
波及=涉及
波折=曲折
驳斥=批驳
勃然大怒=怒发冲冠
补救=弥补
不凡=非凡
不苟言笑=一本正经
不计其数=不可胜数
不可救药=病入膏肓
不劳而获=坐享其成
不伦不类=不三不四
不论=不管
不求甚解=生吞活剥
不三不四=不伦不类
不闻不问=漠不关心
不屑一顾=嗤之以鼻
不修边幅=蓬头垢面
不翼而飞=不胫而走
不约而同=不谋而合
不置可否=模棱两可
不足=缺乏
不足为奇=屡见不鲜
部分=局部
猜测=猜想
猜想=猜测
参差=整齐
残酷=严酷
残余=剩余
惨重=沉重
苍凉=凄凉
嘈杂=喧闹
草草了事=敷衍了事
恻隐=怜悯
策动=策划
策划=筹划
查究=追究
察觉=发觉
察看=观察
诧异=惊讶
姹紫嫣红=万紫千红
差别=差异
差错=过失
差遣=派遣
拆除=撤除
搀和=搀杂
谄媚=奉承
阐明=说明
颤动=颤抖
昌盛=兴盛
长此以往=久而久之
长久=持久
长命=长寿
长年=常年
长驱直入=势如破竹
长于=善于
偿还=归还
怅惘=迷惘
畅所欲言=各抒己见
倡议=建议
超群绝伦=出类拔萃
朝三暮四=朝秦暮楚
沉寂=寂静
沉没=漂浮
陈说=陈述
称说=称呼
称心=满意
称心如意=心满意足
称许=赞许
称誉=称赞
撑持=支撑
瞠目结舌=张口结舌
成本=本钱
承担=承当
承当=承担
承认=供认
诚实=老实
惩办=惩罚
惩处=惩办
痴心妄想=胡思乱想
弛缓=缓和
驰名=著名
迟缓=缓慢
侈靡=奢侈
叱责=斥责
赤诚=热诚
充斥=充满
充沛=充分
崇奉=信奉
抽泣=啜泣
仇人=仇敌
酬报=酬谢
踌躇满志=趾高气扬
臭名远扬=臭名昭著
出名=知名
出其不意=出乎意料
出人意料=出其不意
出头露面=抛头露面
出息=长进
出席=列席
出项=进项
储备=储藏
处罚=处分
处心积虑=挖空心思
处之泰然=泰然自若
触类旁通=举一反三
川流不息=络绎不绝
穿凿附会=牵强附会
创建=创立
纯净=纯洁
纯正=纯粹
唇齿相依=不共戴天
唇枪舌剑=针锋相对
淳厚=淳朴
蠢笨=笨拙
蠢蠢欲动=跃跃欲试
慈爱=慈祥
慈悲=慈善
辞世=谢世
此岸=彼岸
刺眼=扎眼
从军=参军
从容=沉着
从属=附属
葱翠=葱茏
聪慧=聪明
粗鄙=粗俗
粗犷=粗暴
粗枝大叶=粗心大意
篡夺=夺取
璀璨=灿烂
磋商=商量
错综复杂=扑朔迷离
搭档=伙伴
达到=到达
答辩=辩论
答应=容许
打救=搭救
打开=翻开
打扰=打搅
打扫=清扫
打消=消除
大吹大擂=自吹自擂
大腹便便=脑满肠肥
大惑不解=百思不解
大惊小怪=少见多怪
大略=大概
大模大样=大摇大摆
大失所望=事与愿违
大显身手=大显神通
大显神通=大显身手
大摇大摆=大模大样
大义凛然=卑躬屈膝
大众=群众
歹毒=恶毒
歹意=恶意
带领=率领
单薄=薄弱
担心=担忧
耽搁=耽误
殚精竭虑=煞费苦心
胆怯=害怕
胆战心惊=提心吊胆
淡漠=冷淡
当务之急=燃眉之急
当先=领先
当心=留神
当选=中选
道歉=抱歉
得不偿失=得失相当
得失相当=得不偿失
得势=失势
的确=确实
低沉=消沉
低微=卑微
敌视=仇视
诋毁=诽谤
底细=内幕
抵制=抵抗
掂量=衡量
颠倒是非=颠倒黑白
颠沛流离=流离失所
颠三倒四=井然有序
吊销=撤消
调兵遣将=兴师动众
调皮=淘气
调唆=挑拨
掉队=落伍
掉以轻心=漫不经心
喋喋不休=三言两语
顶风=迎风
丢失=丧失
动荡=动乱
动工=开工
动人心魄=扣人心弦
动员=发动
督促=催促
独裁=专制
独断独行=一意孤行
独身=单身
独特=共同
独一无二=无独有偶
独自=单独
端详=打量
短少=缺少
对比=比照
对症下药=有的放矢
多次=屡次
咄咄逼人=盛气凌人
扼守=把守
恶感=反感
恶浊=肮脏
尔后=此后
发达=兴旺
发呆=发愣
发觉=觉察
发掘=开掘
发愣=发呆
发明=创造
发誓=赌咒
发售=出售
发展=开展
翻然悔悟=回心转意
凡是=但凡
繁茂=茂盛
繁杂=冗杂
反复无常=翻云覆雨
反击=还击
反抗=对抗
反馈=反应
反应=反响
防备=防范
妨碍=阻碍
放荡=放纵
放任=听任
飞驰=奔驰
飞蛾扑火=自取灭亡
飞翔=翱翔
费劲=费力
费神=费心
分离=别离
分明=清楚
氛围=气氛
焚烧=燃烧
奋不顾身=贪生怕死
奋发=发奋
愤恨=愤怒
丰登=丰收
丰满=饱满
丰饶=富饶
丰盛=丰富
风靡=风行
风趣=幽默
风尚=风气
风闻=传闻
风行=流行
风言风语=流言蜚语
风雨飘摇=摇摇欲坠
逢凶化吉=绝处逢生
缝补=补缀
讽刺=挖苦
凤毛麟角=百里挑一
奉公守法=安分守己
否定=否认
肤浅=浅薄
服侍=伺候
服务=效劳
浮荡=飘荡
浮躁=急躁
腐化=堕落
妇孺皆知=家喻户晓
负隅顽抗=垂死挣扎
赴汤蹈火=出生入死
富丽=华丽
富余=充裕
腹背受敌=四面楚歌
覆灭=毁灭
改革=变革
改过=改正
改悔=悔过
改进=改良
改良=改进
改邪归正=弃暗投明
干枯=枯槁
干涉=干预
干燥=枯燥
肝脑涂地=粉身碎骨
尴尬=为难
感动=打动
感激=感谢
感叹=感慨
刚愎自用=我行我素
刚才=方才
刚劲=刚毅
刚强=坚强
高傲=傲慢
高低=上下
高峰=顶峰
高视阔步=昂首阔步
高下=高低
高兴=快乐
告别=辞别
告发=揭发
革除=清除
格调=风格
格斗=搏斗
隔阂=隔膜
隔膜=隔阂
各奔前程=分道扬镳
各抒己见=各持己见
根除=铲除
梗塞=堵塞
工夫=时间
公道=公允
功劳=功绩
功效=成效
供给=供应
供应=供给
巩固=稳固
贡献=奉献
构想=设想
购买=购置
姑妄听之=姑妄言之
姑妄言之=姑妄听之
古怪=乖僻
蛊惑=迷惑
鼓吹=宣扬
鼓动=煽动
故乡=故土
故意=成心
顾问=参谋
顾惜=爱惜
瓜熟蒂落=水到渠成
乖僻=古怪
拐弯抹脚=旁敲侧击
关怀=关心
关山迢递=千里迢迢
关照=照顾
观赏=欣赏
贯通=贯穿
光彩=光荣
光顾=光临
光怪陆离=斑驳陆离
光辉=光芒
光芒=光辉
光荣=荣耀
广播=播送
广大=广阔
规避=躲避
规范=标准
规劝=奉劝
瑰丽=绮丽
诡辩=狡辩
诡秘莫测=神出鬼没
果决=果断
过眼云烟=昙花一现
酣战=鏖战
含糊=模糊
涵养=修养
寒暄=应酬
捍卫=保卫
豪言壮语=唉声叹气
好吃懒做=好逸恶劳
好像=仿佛
耗费=消耗
合乎=符合
合适=适宜
和蔼可亲=和颜悦色
和盘托出=一览无余
和善=和蔼
和煦=温暖
和衷共济=同心协力
鹤发童颜=老气横秋
横蛮=野蛮
烘托=衬托
后辈=后代
后发制人=先发制人
后方=前方
后悔=懊悔
后嗣=后裔
后裔=后嗣
候鸟=留鸟
呼啸=吼叫
呼应=照应
忽然=突然
忽视=无视
狐群狗党=沆瀣一气
狐疑=怀疑
胡思乱想=异想天开
花样=把戏
华丽=华美
化险为夷=转危为安
化妆=化装
怀念=思念
怀疑=疑心
坏处=害处
欢送=欢迎
欢腾=欢跃
欢欣鼓舞=欢天喜地
欢迎=欢送
欢跃=欢腾
还俗=出家
还原=复原
幻想=梦想
涣散=松散
荒诞=荒谬
荒谬=荒唐
慌慌张张=从容不迫
谎言=谎话
灰心丧气=心灰意懒
挥金如土=一掷千金
回答=答复
回顾=回忆
回绕=缭绕
回升=上升
回心转意=固执己见
回旋=盘旋
汇合=集合
汇集=聚集
汇聚=会聚
讳疾忌医=文过饰非
绘声绘色=有声有色
晦气=倒霉
毁灭=消灭
浑然一体=天衣无缝
浑水摸鱼=趁火打劫
混充=假冒
混同=混淆
豁然开朗=恍然大悟
活跃=活泼
火热=炽热
火上浇油=推波助澜
火烧眉毛=迫在眉睫
货真价实=名副其实
获悉=得悉
祸害=祸患
祸患=祸害
讥笑=嘲笑
饥寒交迫=丰衣足食
机关用尽=无计可施
机会=时机
机警=机敏
基本=根本
基础=根底
激动=冲动
激励=鼓励
激烈=剧烈
吉祥=不祥
吉兆=凶兆
即便=即使
极力=竭力
急切=急迫
急躁=耐心
集思广益=群策群力
瘠薄=贫瘠
计策=计谋
计划=方案
计谋=计策
伎俩=手段
寄存=存放
寄人篱下=仰人鼻息
冀望=期望
加入=参加
家徒四壁=一贫如洗
价值连城=无价之宝
驾轻就熟=轻车熟路
假如=假设
尖锐=锋利
坚持不懈=持之以恒
坚定=坚决
坚固=巩固
坚韧不拔=坚定不移
坚如磐石=安如磐石
坚挺=坚硬
间断=连续
艰苦=艰辛
艰难=困难
艰涩=晦涩
监督=监视
缄默=沉默
俭朴=简朴
简略=简单
见异思迁=三心二意
建设=建立
健步如飞=大步流星
健康=安康
健壮=强健
践约=失约
江河日下=每况愈下
将遇良才=棋逢对手
僵滞=呆滞
疆土=国土
交叉=穿插
交错=交织
交界=接壤
交口称誉=有口皆碑
焦躁=烦躁
侥幸=幸运
矫揉造作=装腔作势
脚踏实地=兢兢业业
搅扰=烦扰
较量=比赛
教导=教诲
教诲=教导
教唆=唆使
皆大欢喜=大快人心
接管=接收
接壤=交界
接受=承受
揭穿=戳穿
揭发=揭露
揭示=提醒
节俭=节省
节令=季节
杰出=出色
洁净=干净
结党营私=营私舞弊
结构=构造
结束=完毕
解雇=辞退
解救=挽救
解说=讲解
解体=崩溃
界线=界限
界限=界线
金玉其外;败絮其中=华而不实
津津乐道=津津有味
紧密=严密
谨慎=慎重
锦囊妙计=神机妙算
近朱者赤;近墨者黑=耳濡目染
进退维谷=进退两难
进行=停止
进展=停顿
禁受=经受
禁止=制止
经受=禁受
经验=经历
惊恐=惊慌
惊心动魄=触目惊心
精力=精神
精美=精巧
精密=精细
精疲力竭=筋疲力尽
精确=准确
精髓=精华
精益求精=锦上添花
井底之蛙=坐井观天
井井有条=有条不紊
景色=风光
警戒=戒备
警惕=警觉
敬爱=亲爱
敬佩=敬仰
究竟=终究
久远=长远
旧居=故居
旧址=原址
就地取材=因地制宜
居心=存心
居住=寓居
拘捕=逮捕
拘谨=拘束
拘束=拘谨
局部=部分
局面=场面
举荐=推荐
举世无双=独一无二
举足轻重=无足轻重
巨大=宏大
巨匠=大师
拒绝=回绝
具体=详细
距离=间隔
聚精会神=专心致志
卷土重来=东山再起
决裂=分裂
诀窍=窍门
觉醒=觉悟
均衡=平衡
俊杰=豪杰
竣工=完工
开办=创办
开辟=开拓
开场=收场
开创=创始
开明=开通
开始=开端
刊登=登载
勘误=订正
看待=对待
慷慨=大方
考查=考察
考究=讲究
苛捐杂税=横征暴敛
可爱=心爱
可望不可即=望尘莫及
克敌制胜=旗开得胜
克服=克制
克复=光复
克制=抑制
刻骨仇恨=恨之入骨
恪守=遵守
垦荒=开荒
坑骗=欺骗
空阔=空旷
空中楼阁=海市蜃楼
恐怖=恐惧
恐吓=恫吓
口不应心=口是心非
扣留=拘留
苦口婆心=语重心长
酷爱=热爱
酷热=炎热
夸大=夸张
夸大其词=言过其实
夸张=夸大
垮台=倒台
快马加鞭=马不停蹄
快慰=欣慰
宽敞=宽阔
宽泛=广泛
款待=招待
旷废=荒废
旷野=原野
亏本=赔本
岿然不动=纹丝不动
溃退=败退
困乏=疲乏
扩充=扩大
来临=降临
谰言=流言
狼吞虎咽=饥不择食
狼子野心=野心勃勃
朗诵=朗读
牢固=结实
牢靠=可靠
老本=成本
老生常谈=陈词滥调
老师=教师
勒索=讹诈
雷同=相同
累赘=负担
冷嘲热讽=冷言冷语
冷言冷语=冷嘲热讽
离开=分开
离职=离任
黎明=拂晓
理睬=理会
理会=理睬
理所当然=天经地义
历历在目=记忆犹新
厉害=凶猛
立功=犯罪
立刻=立即
隶属=从属
连贯=连接
联合=结合
联系=联络
良久=好久
凉快=凉爽
凉爽=凉快
两全其美=一举两得
了解=理解
劣势=优势
临阵磨枪=临渴掘井
伶牙俐齿=能说会道
灵活=灵敏
灵巧=乖巧
凌乱=混乱
凌辱=欺侮
领导=指导
领路=带路
领有=拥有
浏览=阅读
流动=活动
流放=放逐
流浪=漂泊
流连忘返=恋恋不舍
留念=纪念
留鸟=候鸟
留神=注意
六神无主=心惊肉跳
龙潭虎穴=刀山火海
笼络=拉拢
笼罩=覆盖
漏洞=破绽
碌碌无为=无所作为
路径=途径
路线=道路
驴唇不对马嘴=风马牛不相及
旅行=游览
屡战屡败=百战百胜
沦陷=陷落
论述=阐述
麻痹=麻木
麻烦=费事
麻利=敏捷
埋怨=抱怨
瞒哄=隐瞒
谩骂=咒骂
慢慢=渐渐
漫游=遨游
忙碌=繁忙
盲目=自觉
莽撞=鲁莽
毛病=缺点
矛头=锋芒
冒名顶替=滥竽充数
没精打采=垂头丧气
没落=衰败
眉飞色舞=喜形于色
眉头一皱;计上心来=灵机一动
美好=美妙
门路=路径
糜烂=腐败
秘密=机密
密切=亲密
绵薄=菲薄
面貌=相貌
面面俱到=八面玲珑
面目一新=焕然一新
描述=描绘
灭亡=沦亡
民不聊生=生灵涂炭
名垂青史=流芳百世
名列前茅=首屈一指
名誉=声誉
明亮=亮堂
明哲保身=洁身自好
明争暗斗=尔虞我诈
明知故犯=知法犯法
铭记=铭刻
铭刻=铭记
谬误=错误
摸索=探索
模仿=模拟
模式=形式
陌生=生疏
目标=目的
目不暇接=琳琅满目
目睹=目击
目击=目睹
目迷五色=眼花缭乱
暮年=晚年
内务=外务
纳凉=乘凉
南辕北辙=背道而驰
南征北战=身经百战
呶呶不休=喋喋不休
恼恨=怨恨
能够=可以
能力=才能
匿影藏形=销声匿迹
宁为玉碎，不为瓦全=宁死不屈
凝听=聆听
扭转=改变
浓厚=浓重
怒不可遏=怒形于色
讴歌=歌颂
偶尔=偶然
偶然=偶尔
拍板=点头
徘徊=彷徨
排斥=排挤
排挤=排斥
排山倒海=翻江倒海
派头=气派
盘根错节=错综复杂
判定=断定
叛变=反叛
旁门左道=歪门邪道
旁若无人=目中无人
咆哮=怒吼
培植=扶植
配备=装备
抨击=鞭挞
批改=修改
皮开肉绽=遍体鳞伤
毗连=毗邻
毗邻=毗连
疲乏=疲惫
匹夫之勇=有勇无谋
偏差=偏向
偏重=侧重
剽窃=抄袭
贫苦=贫困
品尝=品味
品行=操行
牵累=连累
谦让=辞让
前怕狼;后怕虎=瞻前顾后
虔诚=忠诚
潜伏=埋伏
浅显=粗浅
强盗=匪徒
强占=侵占
强制=强迫
切磋=商讨
切实=实在
亲热=亲近
侵犯=进犯
侵害=损害
勤俭=节俭
青出于蓝=后来居上
青睐=喜爱
青云直上=平步青云
轻便=笨重
轻浮=庄重
轻活=重活
轻捷=轻盈
轻伤=重伤
轻微=细微
轻易=随便
倾慕=爱慕
清澈=明澈
清除=肃清
清淡=油腻
清贫=贫寒
清晰=明晰
清新=清爽
清秀=娟秀
情天孽海=深仇大恨
情义=情意
情谊=友情
请求=恳求
庆祝=庆贺
罄竹难书=擢发难数
求教=请教
求实=务实
驱赶=驱逐
驱散=遣散
屈从=屈服
屈服=屈从
祛病延年=延年益寿
取得=获得
去世=逝世
趣味=兴趣
全副=全部
全心全意=一心一意
权力=权利
权且=姑且
权势=势力
热气腾腾=热火朝天
人不知;鬼不觉=不知不觉
人情世故=人之常情
人心涣散=一盘散沙
人之常情=人情世故
忍耐=忍受
任凭=听凭
任其自然=听之任之
任人唯亲=任人唯贤
任人唯贤=任人唯亲
容纳=包容
融合=交融
蹂躏=践踏
如果=假如
如醉如痴=自我陶醉
如坐针毡=坐立不安
入手=动手
润滑=光滑
润色=润饰
若即若离=不即不离
若明若暗=泾渭分明
撒谎=扯谎
三思而行=深思熟虑
散布=分布
散步=漫步
丧气=沮丧
丧心病狂=丧尽天良
色调=色彩
杀人不眨眼=杀人不见血
杀人如麻=救死扶伤
沙场=疆场
筛选=挑选
山高水长=天长地久
山穷水尽=日暮途穷
善良=仁慈
善意=好心
善于=擅长
赡养=奉养
赏赐=恩赐
赏心悦目=心旷神怡
上当=受骗
稍微=略微
奢华=豪华
舍身=捐躯
申述=申诉
深厚=深沉
深刻=深入
深入=深化
深入人心=不得人心
深信=坚信
神气=神情
神往=憧憬
审判=审讯
渗透=浸透
升级=晋级
生产=消费
生机=活力
生灵涂炭=水深火热
生事=惹事
生疏=陌生
生硬=僵硬
声调=腔调
声名狼藉=身败名裂
声援=支援
牲畜=家畜
胜利=成功
省得=免得
盛大=浩大
失望=绝望
失约=践约
失职=渎职
湿润=潮湿
十分=非常
时光=光阴
实践=理论
实施=施行
实质=本质
士兵=兵士
事必躬亲=身体力行
事不宜迟=当务之急
势力=权力
势如破竹=势不可当
视死如归=杀身成仁
适合=合适
嗜好=癖好
收购=收买
收集=搜集
收留=收容
收罗=搜罗
收买=收购
收拾=拾掇
手不释卷=孜孜不倦
手段=手腕
手足无措=不知所措
首领=领袖
受命=授命
受权=授权
受罪=享福
授命=受命
授权=受权
疏忽=忽略
舒服=舒适
熟练=纯熟
熟能生巧=游刃有余
束手就擒=束手待毙
树碑立传=歌功颂德
水落石出=真相大白
水平=程度
司空见惯=习以为常
思考=考虑
死里逃生=九死一生
死路=绝路
死皮赖脸=厚颜无耻
死于非命=寿终正寝
松散=松懈
怂恿=鼓动
耸立=屹立
搜查=搜寻
搜罗=网罗
苏醒=清醒
肃穆=庄严
素常=平素
素淡=素净
素日=平日
随便=随意
随声附和=人云亦云
随同=伴随
随心所欲=为所欲为
所向无敌=所向披靡
他人=别人
贪得无厌=得寸进尺
贪婪=贪心
谈论=议论
谈判=会谈
谈笑风生=谈笑自若
谈笑自若=谈笑风生
袒护=包庇
袒露=裸露
探囊取物=十拿九稳
探亲=省亲
探索=探究
探讨=讨论
倘若=假使
逃亡=流亡
特务=间谍
提高=进步
提前=提早
提问=发问
体会=领会
体谅=谅解
替换=交换
天翻地覆=翻天覆地
天昏地暗=昏天黑地
挑拨=挑唆
听从=遵从
通通=统统
同床异梦=貌合神离
统统=通通
痛改前非=改过自新
偷盗=盗窃
头绪=眉目
突破=打破
途程=路程
屠戮=杀戮
团圆=团聚
推测=揣测
推迟=推延
推敲=琢磨
推却=推辞
颓丧=颓废
退让=让步
唾弃=鄙弃
挖掘=发掘
纨绔子弟=花花公子
完结=结束
完满=完美
完整=完好
惋惜=可惜
万众一心=众志成城
望穿秋水=望眼欲穿
望梅止渴=画饼充饥
望眼欲穿=望穿秋水
威逼=威胁
威望=声威
违背=违犯
违反=违背
唯利是图=利欲熏心
伪装=假装
未来=将来
温柔=温顺
温习=复习
文质彬彬=温文尔雅
闻名=出名
乌七八糟=乱七八糟
无拘无束=自由自在
无可奈何=迫不得已
无所不包=包罗万象
五湖四海=四面八方
吸取=汲取
习俗=风俗
习用=惯用
喜爱=喜欢
喜好=爱好
先人=祖先
先兆=前兆
现在=如今
相互=互相
小题大作=借题发挥
谐和=和谐
谢世=去世
心有余而力不足=爱莫能助
新鲜=新颖
信用=信誉
兴高采烈=兴致勃勃
兴旺=兴隆
兴许=也许
兴妖作怪=兴风作浪
行贿=受贿
凶狠=凶恶
胸怀=襟怀
雄伟=宏伟
羞愧=惭愧
须要=需要
许可=答应
宣称=声称
喧嚷=吵嚷
炫耀=夸耀
勋绩=功勋
驯服=征服
淹没=吞没
湮没=埋没
言归于好=破镜重圆
言外之意=弦外之音
眼光=目光
厌烦=腻烦
样式=款式
摇晃=摇摆
遥想=遐想
一尘不染=一干二净
一干二净=一尘不染
一举两得=一箭双雕
衣着=穿着
依旧=照旧
依据=根据
依然=仍然
依照=按照
移动=挪动
移花接木=偷梁换柱
以其人之道;还治其人=以眼还眼
以至=以致
益处=好处
毅然=决然
因而=因此
因由=来由
荫蔽=隐蔽
音讯=消息
引荐=举荐
赢得=博得
佣人=仆人
拥戴=拥护
永恒=永久
勇敢=英勇
用处=用途
用途=用处
犹豫不决=优柔寡断
油腔滑调=油嘴滑舌
油嘴滑舌=油腔滑调
游玩=玩耍
友情=友谊
愚蠢=愚笨
愚弄=捉弄
舆论=言论
预料=意料
预想=料想
冤家路窄=狭路相逢
冤屈=委屈
原本=本来
允诺=许诺
灾害=灾祸
灾祸=灾害
葬送=断送
造就=培养
责备=指摘
增强=加强
憎恶=憎恨
憎恨=憎恶
扎眼=刺眼
瞻望=展望
展示=展现
展望=瞻望
展现=展示
照管=看管
珍藏=收藏
珍重=保重
斟酌=推敲
争夺=抢夺
正直=耿直
支离破碎=四分五裂
知道=晓得
执著=固执
只管=尽管
只有=只要
指责=责备
治本=治标
治标=治本
忠诚=忠实
种类=品种
重复=反复
周围=四周
逐步=逐渐
主见=主意
嘱咐=吩咐
注目=瞩目
注视=凝视
贮存=储存
祝福=祝愿
祝贺=恭喜
祝愿=祝福
专长=特长
专断=独断
装扮=打扮
装聋作哑=装疯卖傻
装腔作势=装模作样
装置=安装
状况=情况
追本溯源=追根究底
追究=追查
准则=原则
卓有成效=行之有效
着急=焦急
着落=下落
仔细=认真
姿势=姿态
资料=材料
自负=自傲
自高自大=自命不凡
自己=本人
自取灭亡=自掘坟墓
自如=自若
自若=自如
自身=本身
自言自语=喃喃自语
自由=自在
宗旨=目标
走漏=透露
足迹=脚印
钻研=研究
左思右想=冥思苦想
坐山观虎斗=坐观成败
坐享其成=坐收渔利
萌发=萌生
萌生=萌发
银白色=雪白色
遍布=遍及
百年不遇=千载难逢
贪心=贪婪
简直=几乎
仪式=典礼
漠然=淡然
愚昧=愚蠢
信心=自信心
真谛=真理
陶醉=沉醉
积攒=积累
照耀=照射
出乎意料=出人意料
通顺=通畅
居然=竟然
井然有序=有条有理
搜寻=搜索
警觉=警惕
洋溢=弥漫
训斥=怒斥
慢悠悠=慢吞吞
未免=不免
瞬间=霎时
交织=交错
孤独=孤单
偏僻=偏远
轻轻=悄悄
深造=进修
慢吞吞=慢悠悠
模拟=模仿
发愁=忧愁
自豪=骄傲
感谢=感激
赞叹=赞赏
驰名中外=举世闻名
造成=形成
空旷=空阔
斥责=呵斥
逐渐=逐步
美妙=美好
凭借=凭仗
欢快=愉快
预计=估计
重大=严重
机敏=机警
庆贺=庆祝
相似=类似
失魂落魄=魂不守舍
申诉=申述
酬谢=酬报
艰辛=艰苦
困境=窘境
自在=自由
精通=通晓
纤弱=柔弱
追寻=追随
挑逗=撩拨
困顿=窘迫
尽管=虽然
粘稠=稀薄
解决=处理
辍学=停学
用意=意图
因此=因而
巧夺天工=鬼斧神工
奇迹=奇观
资助=赞助
幸好=幸亏
新生=重生
疑惑不解=迷惑不解
丰硕=丰盛
泄气=气馁
奇观=奇迹
即使=即便
柔美=优美
收容=收留
偏远=偏僻
如同=好像
清爽=清新
素来=从来
设施=设备
帮助=协助
一一=逐个
坦然=安然
奥秘=奥妙
惊艳=冷艳
葱茏=葱翠
凛冽=寒冷
饶恕=宽恕
羞辱=侮辱
姿态=姿势
相熟=熟悉
磨难=磨练
柔嫩=娇嫩
时尚=时髦
简朴=俭朴
惟一=唯一
一直=不断
探访=看望
忍受=忍耐
惊动=惊扰
造型=外型
舒适=温馨
优异=优良
浅色=淡色
布局=规划
透出=显露出
富裕=富有
美元=美圆
新华网=新华社
唉声叹气=长吁短叹
爱好=喜好
爱怜=怜爱
爱莫能助=心有余而力不足
爱慕=倾慕
爱惜=顾惜
安分守己=循规蹈矩
安眠=安息
安排=布置
安然无恙=平安无事
安如磐石=安如泰山
安闲=清闲
安详=安宁
安逸=闲适
安置=安顿
安装=装置
按照=依照
暗昧=暧昧
暗影=阴影
肮脏=龌龊
昂然挺立=昂首挺立
昂首=俯首
昂首阔步=高视阔步
遨游=漫游
翱翔=飞翔
鏖战=酣战
八面玲珑=面面俱到
巴不得=恨不得
跋山涉水=翻山越岭
把柄=凭据
把守=扼守
罢黜=免除
罢了=而已
白发=青丝
白话=文言
白皙=白净
百里挑一=凤毛麟角
百年大计=权宜之计
百思不解=大惑不解
败退=溃退
拜访=访问
拜会=拜见
斑驳陆离=光怪陆离
伴随=随同
帮凶=爪牙
包庇=庇护
包罗万象=应有尽有
包容=容纳
褒奖=贬责
褒义=贬义
宝物=废物
饱满=丰满
保持=坚持
保存=保管
保护=维护
保密=失密
保守=激进
保卫=捍卫
保养=颐养
保障=保证
保重=珍重
报复=报仇
报忧=报喜
抱负=志向
抱恨终天=死不瞑目
抱歉=负疚
抱怨=埋怨
暴涨=暴跌
爆发=迸发
卑劣=卑鄙
卑微=低微
杯水车薪=无济于事
悲哀=悲痛
悲惨=凄惨
悲叹=哀叹
背道而驰=南辕北辙
背离=背叛
奔波=奔走
奔驰=飞驰
奔流=奔腾
本来=原本
本领=身手
本人=自己
本色=本性
本身=自身
本义=转义
本质=实质
笨拙=蠢笨
崩溃=解体
逼近=迫近
逼上梁山=铤而走险
比方=比如
比赛=竞赛
比照=对比
笔供=口供
笔挺=笔直
笔直粗壮=挺拔伟岸
鄙弃=唾弃
鄙视=轻视
必然王国=自由王国
必须=必需
避重就轻=拈轻怕重
边际=边沿
边界=边境
鞭策=鞭笞
鞭长莫及=力所不及
鞭挞=抨击
贬斥=贬低
便捷=便利
变更=变卦
变化多端=变化无常
变幻无穷=千变万化
变迁=变化
变质=蜕变
遍体鳞伤=体无完肤
辩白=分辩
辩论=争辩
标记=标志
标准=规范
表露=流露
表明=标明
表演=扮演
表扬=褒扬
表彰=惩处
别开生面=别具一格
别离=分别
别人=他人
蹩脚=糟糕
秉性=天性
病入膏肓=不可救药
波动=动摇
波澜=波涛
播送=广播
博得=赢得
博览群书=博学多才
搏斗=格斗
薄弱=单薄
补台=拆台
补缀=缝补
不卑不亢=不骄不躁
不必=不用
不耻下可=虚怀若谷
不打自招=屈打成招
不迭=不及
不断=不时
不妨=无妨
不共戴天=势不两立
不管=不论
不寒而栗=毛骨悚然
不即不离=若即若离
不仅=不只
不禁=不由
不胫而走=不翼而飞
不堪一击=摧枯拉朽
不可开交=不亦乐乎
不可胜数=数不胜数
不落窠臼=步人后尘
不毛之地=穷山恶水
不免=难免
不谋而合=不约而同
不请自来=不速之客
不屈不挠=百折不挠
不容置疑=无可置疑
不识好歹=不识抬举
不务正业=游手好闲
不言而喻=显而易见
不厌其烦=诲人不倦
不知所措=手足无措
布告=公告
步调=步伐
才华=才气
才华出众=才华盖世
才能=才干
材料=资料
财产=财富
裁决=判决
采纳=采用
参差不齐=良莠不齐
参加=参与
参军=从军
参谋=顾问
残害=摧残
残花败柳=半老徐娘
惭愧=羞愧
惨无人道=惨绝人寰
灿烂=绚烂
仓猝=匆促
沧海一粟=九牛一毛
苍白=惨白
苍老=衰老
苍穹=天穹
操办=筹办
操持=料理
操劳=劳累
操行=品行
操纵=支配
草木皆兵=风声鹤唳
侧重=偏重
测量=丈量
测验=检验
策略=战略
查问=查询
趁势=顺势
成长=生长
成功=胜利
成绩=成果
成品=废品
成千盈百=成百上千
成群结队=形单影只
成效=效果
成心=故意
成竹在胸=心中有数
承继=承袭
承受=接受
乘风破浪=披荆斩棘
乘凉=纳凉
惩前毖后=小惩大诫
程度=水平
澄清=廓清
吃力=费劲
嗤之以鼻=五体投地
迟钝=愚钝
迟疑=踌躇
持久=耐久
持之以恒=锲而不舍
耻辱=羞耻
叱骂=责骂
赤胆忠心=忠心耿耿
赤身露体=一丝不挂
赤手空拳=手无寸铁
赤心=丹心
炽热=火热
充当=充任
充耳不闻=不闻不问
充分=充沛
充满=充溢
充裕=富余
冲动=激动
冲突=抵触
憧憬=神往
宠爱=溺爱
抽象=笼统
仇敌=仇人
仇视=敌视
惆怅=难过
愁眉锁眼=眉开眼笑
筹划=谋划
臭名昭著=臭名远扬
出奔=出走
出兵=收兵